XXXXXXXXXXXXXXXXXXX
X.................X
X.................X
X.................X
X.................X
X.................X
X.................X
X.................X
X.................X
X........O........X
X.................X
X.................X
X.................X
X.................X
X.................X
X.................X
X.................X
X.................X
XXXXXXXXXXXXXXXXXXX
