XXXXXXXXXX..XXXXXXX
X........X..X.....X
X....XX..X.XX.....X
X....XX...........X
X........X....XX..X
XXX......XXXX.....X
...................
XX................X
XX................X
XXXX.....O........X
X.................X
X..XXXX..XX.......X
X..X..............X
X..X...........XXXX
...XXXX..XX........
X..X...........XXXX
X........X..X.....X
X........X..X.....X
XXXXXXXXXX..XXXXXXX
