XXXX.XXXXXXXXXXXXXX
X........X........X
X........X........X
X.................X
X..............XXXX
X.................X
X.................X
X.................X
X.................X
XXXX.....O........X
X.................X
X.................X
X.................X
X.................X
...................
X.................X
X.................X
X.................X
XXXX.XXXXXXXXXXXXXX
